#########################################
#       ....                            #
# #################  ################## #
#                   ......              #
#                        ...            #
#        ###  #############             #
#          #  #                         #
#          #  #############             #
#                                       #
#########################################
